###########################
#OOGOOOOGOOGOQOOOOOGOOOOOO#
#O########OO#OG##OO######G#
#G#GOOOOOGOOOOOOOOOOQOGO#O#
#O#O####OO#####OO#OO###O#O#
#O#OOOO#OOOOGOOOOOO#OOOO#O#
#O#O#OO#GO##O##GG#OOOO#O#O#
#GOO#OG#OO#OOO#OOOO#OO#GOO#
#OQO#OOOGOOOOOOOOOOOOO#OOO#
#OOO#OO#OO#OOO#OOOO#OO#OGO#
#O#O#OO#OO##O##OOOO#OO#O#O#
#O#OOOO#OOOOOOOOOOO#OOOO#O#
#G#O####OO#####OOOO####O#G#
#O#OGOOOOGOOOGOOOOOOQOOO#O#
#O########OO#OOOO########O#
#OOOOOOOGGOOOOOOOOOOOOOOQO#
###########################